598 387 580 286 228 140 125 154 176 55 57 35 26 736 741 598 387 314 286 228 316 125 154 83 55 57 99 26 23 31 12 8 10 59 3 6 19 15 25 71 145 96 115 205 162 158 264 241 355 254 696 314 736 1
200 527 187 350 850 310 101 192 363 350 850 101 310 192 165 1065 460 39 130 336 306 282 130 336 200 527 187 350 1054 434 101 192 363 350 101 192 165 857 1567 32 100 64 306 374 350 40 306 184 1616 505 79 64 374 295 350 22 77 126
26 55 41 256 30 31 47 110 127 259 276 26 55 1 304 30 31 47 110 356 123 404 1 383 94 152 1 46 491 211 129 1 211 44 129 1 93 47 110 127 259 1 137 137 304 30 47 110 356 123 404 1 400 22 44 85 69 251 251 1 400 22
248 899 50 13 39 30 130 382 103 72 492 214 75 214 95 821 114 17 22 114 36 285 66 186 605 482 95 91 75 151 726 36 30 22 64 52 570 758 118 103 168 52 994 118 79 13 210 233 136 233 48 38 763 248 60 91 41 430 130 14 11 257
213 364 268 54 313 144 47 144 47 273 26 77 129 51 171 180 213
938 172 336 133 636 463 594 610 454 215 851 92 78 20 463 594 363 318 242 455 1 699 97 60 206 1
10 1 56 3 10 1 61 15 27 10 84 35 139 23 25 15 27 10 146 99 25 15 27 10 137 236 25 15 27 10 176 139 15 3 10 1 139 15 3 10 152 213 411 646 220 83 15 3 10
9 18 7 27 160 16 9 18 7 27 41 606 4 6 1 211 7 9 349 18 9 16 7 160 18 9 16 7 1 191 9 7 196 11 116 9 29 7 11 116 9 29 41 341 36 13 349 90 5 16 11 160 90 5 16 11 141 112 21 1 289
13 371 20 50 13 42 13 569 54 313 159 7 20 25 4 154 358 223 52 752 199 75 95 75 52 51 125 316 174 125 316 502 28 371 171
188 83 140 1 188 83 140 1 176 140 98 1 176 140 98 1 188 83 140 1 188 83 140 1 188 83 140 1 316 98 83 1 316 83 1 99 83
39 1 428 39 13 43 41 570 128 52 60 2 607 128 95 41 811 95 75 2 167 23 2 54 45 1
6 4 80 26 686 206 684 193 692 885 475 31 262 155 5 90 29 20 197 8 175 26 338 36 14 120 31 46 175 19 3 205 25 96 26 31 262 175 6 4 15 8 262 26 31 789 205 158 96 19 25 3 46 326 120
16 20 34 28 51 33 7 2 51 161 172 63 49 1 328 33 7 62 2
30 88 5 392 3 1 198 7 43 190 358 167 107 49 88 108 345 358 128 193 234 392 345 358 392 345 1 376 13 30 88 417 3 1 175 7 43 190 348 167 117 49 88 108 334 348 128 193 234 417 334 348 417 334
34 40 134 9 34 40 65 9 34 40 157 9 34 40 65 9 34 40 157 34 40 69 34 40 134
99 55 125 1 99 55 125 1 139 83 140 1 139 83 140 1 139 83 140 1 139 83 140 1 397 171
107 12 73 211 129 44 114 182 57 23 46 46 31 26 50 46 93 26 8 113 85 75 11 85 173 216 94 35 330 46
102 29 183 209 142 282 40 142 204 116 68 192 9 68 354 217 179 142 179 215 155 144 68 107 90 86 583 160 133
11 89 5 11 1 201 5 11 1 86 3 8 1 170 5 28 1 170 5 28 51 5 28 1 170 5 28 2 107 3 21 1 181 20 7 1 181 20 7 68 20 7 1 181 20 7 1 61 19 4
1 170 5 28 2 246 6 24 8 1 132 6 24 8 132 6 3 10 1 132 6 3 10 1 132 6 24 8 1 132 6 24 8 132 6 3 10 1 132 6 3 10 2 159 24 21 1 86
16 471 74 455 15 988 60 203 95 143 2 242 16 33 7 342 133 242 16 33 7 242 51 33 7 80 242 51 33 7 80 242 1
71 15 6 4 1 56 32 3 10 2 107 32 3 10 56 32 3 1 56 32 3 10 1 61 32 3 1 478 29 40 5 464 25 32 3 1 163 92 15 6 10 1 149 15 6 10 1 322 100 16 9 17 144 100 16 9 17 107 6 10 46 12 135
36 63 49 43 324 662 549 15 3 21 12 381 273 15 3 21 12 529 425 36 43 13 49 43 735 273 15 3 21 12 381
35 203 60 97 382 45 47 814 8 31 2 257 30 94 114 1257 18 11 44 494 586 657 995 576 604 536 9 17 171 259 1 597 30 118 207 291
82 383 379 130 64 22 64 130 8 130 233 306 39 194 130 64 39 130 34 102 76 350 288 101 40 40 34 17 130 6
108 51 403 17 43 108 95 399 586 257 365 667 17 18
126 159 205 78 34 54 90 680 111 111 52 159 205 106 150 136 96 210 71 373 64 106 150 210 71 46 25 42 39 173 25 69 29 401 25 126 39 138 115 82 71 298 17
57 56 10 6 3 96 1 163 56 6 3 10 1 163 57 8 3 15 56 10 6 3 26 1175 786 670 777 70 23 96 8 26 15 3 56 3 10 6 23 56 3 10 6 91 234 95 52 163 82 15 6 3 273 48 10 15 6 273 82 15 6
101 420 42 14 49 420 42 14 848 36 64 318 64 88 651 42 64 442 42 64 848 42 64 318 64 651 42 64 442 42 64 848 42 64 858 193 651 442 63 43
4 12 63 14 43 739 36 739 33 14 43 161 246 37 14 101 190 274 390 33 652 63 14 101 390 154 78 652
139 124 140 1 139 124 140 1 84 124 55 1 84 124 55 1 84 124 55 1 236 26 55 1 84 124 55 1 84 124 55 1 176 23
75 151 103 2 246 6 24 10 738 75 151 103 164 1255 6 10 61 32 24 66 6 181 40 34 246 6 10 164 1255 6 10 61 32 24 150 66 6 181 40 34 246 6 10 41 625 66 32 27 597 235 168 143 2 222 66 32 27
310 166 518 286 57 135 66 1435 226 58 24 82 557 114 79 767 129 48 10 38 84 57 124 316 286 1 856 130 546 307 339 247 546 251
565 300 336 7 573 541 161 72 463 89 72 62 89 267 12 72 101 89 72
62 62 268 191 29 11 11 261 179 266 332 219 242 25 6 32 324 145 25 6 324 145 25 6 324 317 29 9 32 324 145 25 6 145
45 2 89 45 141 178 350 237 501 31 1 320 178 350 237 364 45 141 178 244 81 109 67 106 81
33 16 7 80 133 170 311 7 242 336 14 16 80 133 51 242 1 496 14 80 162 16 471 74 455 15 988 60
96 15 418 96 15 418 96 15 418 96 15 418 96 15 1 191 40 34 187 96 15 512 168
801 215 54 267 182 278 405 97 276 123 525 259 215 301 558 20 178 356 463 270 622 169 72 421 1237 83 1 359 617 318 420 88 152 814 41 669 43 391 45 285 18 122 51 211 85 84 1 553 95 18 47 769 519 26 54 47 83 220 163 15 121
42 14 101 515 514 120 42 14 101 98 616 629 514 120 42 14 101 1044 337 63 14 101 35 99 99 359 879 337 63 14 101 438 797 199 42 63
262 132 80 4 19 81 35 84 149 238 162 15 96
24 37 253 1 58 24 37 253 1 58 24 37 253 1 58 37 24 253 1 58 24 37 253 1 58 24 37 253 1 58 24 37 253 1 58 24 37 253 1 496 190 1 520 237 1 196 85 1 294 43 1 520 237 1 196 85 1
65 34 11 2 183 64 30 546 34 11 54 64 30 192 352 34 180 9 34 157 11 65 5 11 65 65 11 76 306 30 130 469 308 1886 102 40 5 282 79 13 462 40 5 282 79 13 546 40 5 102 40 5
506 92 388 36 1323 203 95 143 41 1671 235 97 143 60 41 1317 278 95 97 52 2 624 1527 16 5
200 6 4 177 200 6 4 74 200 6 4 155 200 6 4 162 1 105 6 4 116 138 4 32 166 200 6 4 138 32 4 74 138 32 4 177 138 32 4 74 138 32 4 158 1 58 32 4 162 1 58 32 4 116 138 4 32 166 138
2 183 30 501 41 570 52 60 128 41 783 95 60 118 41 622 75 60 91 41 638 169 127 113 173 2 167 2 138 1 620 52 91 2 354 143 60 41 490 50 42 13 1 181 20 5 11 2 204 42 13 30 331 42 13 30 164 835 52 128 193 41
11 41 352 7 11 2 134 5 17 134 5 17 1 258 5 17 41 469 5 17 2 65 7 11 65 7 11 1 186 7 11 41 352 17 18 2 134 5 17 134 5 17 1 258 5 17 41 469 5 17 2 65
415 153 36 63 1044 337 126 63 14 121 220 220 961 879 337 126 63 14 515 833 252 126 42 14 98 616 629 833 252 126 42 14 1005 199 36 63 14 35 99 99 359
170 101 63 14 252 285 437 1 529 16 22 64 101 285 280 636 120 126 97 14 938 363 89 167 1 855 278 97 64 996 89
61 46 26 61 137 8 12 61 46 23 25 61 46 26 25 1 99 55 125 99 55 125
8 26 1 46 26 38 1 346 11 129 47 168 1275 307 2 539 24 102 18 44 102 44 18 182 23 10 106 182 23 10 244 82 12 23 106 12 23 81 10 1 738 37 23 81 55 1301 55 81 251 81 37 1 82 66
736 314 1 580 140 736 1 316 314 736 1 580 736 140 1 316 314 736 1 955 140 314 1 955 140 387 1 681 736 140 1 316 736 387 1 316 387 736 1 316 387 736 1
103 164 1255 6 10 61 32 24 66 6 181 40 34 246 6 10 41 642
49 42 223 1500 17 62 33 1 311 62 224 17 1 478 17 33 18 1 298 17 33 17 62 2 184 33 28
331 335 276 492 118 372 319 1 1172 215 204 431 88 318 72 335 204 88 37 203 97 1283 284 239 713 447 1 289 148 573 372 164 911 97 60
331 30 25 6 4 637 60 115 499 1257 219 199 735 484 417 6 4 291 14 194 283 39 25 6 4 664 91 166 417 6 4 331 30 194 341 94 25 6 4
387 1 1132 228 387 1 1132 228 387 1 1132 228 387 1 681 228 736 1 955 228 387 1 955 228 387 1 394 387 736 1 316 387 736 1 955 387 140 1 681 736 140 1 316 736 387 1 681 736 140 1 681 140 736 1 316 387
131 340 153 330 56 126 42 13 513 188 99 99 507 526 97 52 285 51 363 101 54 515 80 15 27 14 36 63 118 203 169 172 143 60 943 472 126 101 333 120 363 169 33 805 36
18 49 348 136 117 13 30 88 334 202 136 49 18 117 334 3 1 303 5 11 45 136 1 181 5 18 28 18 334 3 1 412 45 5 11 136 1 145 1 412 5 18 49 481 12 136 242 13 30 88 455 263 54 49 18 242 455
73 83 57 1 740 129 333 148 259 57 124 1 84 57 124 1 139 124 26 1 139
184 159 37 590 107 21 506 1 149 16 13 223 374 51 183 51 374 51 54 90 107 5 7 74 51 54 74 51 7 21 136 120 107 3 107 4 3 252 107 3 4 481 78 20 7 689 32 27 21 164 930 42 64 49 405 689 537 20 100 350 89 260 1 619
425 374 51 107 19 235 296 212 223 700 420 144 463 15 27 4 36 63 14 245 143 60 420 300 363 161 172 63 14 470 530 18 60 107 126 63 101 538 180 30 63 3 72 290 153 36 92 15 3 21 212 425 278
17 1 376 114 25 32 10 1 400 114 50 79 13 1 61 15 434 22 726 36 22 497 1 1062 79 22 64 30 899 22 64 30 1127 131 36 22 13 402 65 348 114 19 3 10 1 386 25 32 24 10 323 68 157 222 24 40 9 68 51
1 99 121 154 1 99 121 154 1 84 57 83 1 84 57 83 1 84 57 83 1 84 57 171 259 57 1
169 87 214 95 75 113 87 232 87 113 127 111 97 52 123 127 225 127 123 113 111 75 60 169 113 225 113 169 113 95 75
15 418 96 15 418 96 15 1 258 33 34 17 71 32 306 63 64 39 71 32 222 32 200 71 1 46 32 3 24 2 173 32 3 24 41 570 52 103 187 96 15 418 96 15 418 96 15 418 96 15 418 96 15 418 96 15 418 96 15 1 191 40
756 73 408 438 1068 168 151 91 248 148 408 756 73 146 438 929 266 361 524 545 148 757 536 628 1578 143 103 206 372 1844 151 91 447 248 447 2 1068 151 91 248 447 1357 103 206 207
128 193 86 327 72 62 141 18 68 20 193 144 68 20 144 51 5 118 184 51 5 184 68 9 91 133 68 9 133 144 100 133 29 374 36 18 65 47
2 452 52 91 1 86 12 3 41 570 143 128 1 46 15 27 41 622 111 52 128 1 304
395 63 101 395 63 49 245 63 39 245
3 8 154 348 50 13 194 42 50 42 13 89 154 316 174 154 316 502 11 13 371 42 50
105 27 24 21 750 401 168 178 122 34 76 148 208 150 109 24 21 32 327 208 150 109 21 32 24 81 480 24
9 28 26 348 111 91 194 97 97 52 91 407 89 54 487 11 371 54 89 313 348 50 194 19 3 8 1042 89 54 487 11 20 371 19 25 19 54 5 19 29 20 5 159 11 20 19 8
105 27 24 21 153 83 34 508 275 79 418 150 109 21 83 24 302 105 24 221 98 302 109 24 21 32 40 33 34 28 70 150 105 27 21 21 83 27 24 302 32 105 24 124 150 83 302 311 28 121 27 21 24 32
637 60 91 41 544 12 35 228 2 136 8 23 125 164
40 157 34 40 65 34 40 157 34 40 157 34 40 134 34 40 134 9 34 40 65 9 34 40 157 9 34 40 65 9 34 40 157 34 40 69 34 40 134 34 40 134 5 40 65 5 40 157 3 40 65 5 40 157 34 40 157 64 79 134
32 27 222 32 27 222 32 27 1 311 17 44 62
3 21 171 47 178 393 13 90 100 16 3 21 12 48 21 12 108 301 299 344 28 53 15 96 92 3 21 12 15 149 21 834 777 96 92 3 21 12 15 26 98 83 322 5 17 77 56 12 16 90 77 3 10 12 12 57
56 479 883 56 1037 734 3071 85 110 171 239 85 110 171 239 85 110 171 239 85 110 171 239 85 110
11 141 112 21 1 289 5 11 175 96 19 8 3 158 96 19 8 3 164 1154 11 5 303 11 5 20 90 155 11 5 20 90 1 174 28 18 48 96 12 15 21
171 259 183 30 88 171 869 183 30 88 283 30 88 684 283 30 88 331 49 88 268 331 49 88 45 239 350 49
81 1 46 38 81 1 147 38 8 1 46 38 81 1 46 38 81 1 104 81 8 1 104 8 81 1 46 38 81 1 147 8 38 1 104 81 8 1 106
418 71 233 40 5 5 40 17 187 78 1 105 10 71 6 3 32 3 10 66 1 198 25 48 25 4 13 14 36 117
264 1 643 92 19 27 501 27 149 86 109 218 92 32 27 2 260 32 27 2 437 27 24 1 149 1 109 24 1 149 1 208 32 27 24 1 149 1 105 27 24 1 149 1
108 334 348 128 193 234 417 334 348 417 334 1 388 13 30 88 392 3 1 349 7 43 190 358 167 107 49 88 108 345 358 128 193 234 392 345 358 392 345 1 388 30 88 5 392 3 1 198 7 43 190 358 167 107 49 88 108 345 358 128 193 234 392
135 66 32 6 1 105 71 66 6 1 673 613 143 103 92 32 27 307 92 32 27 260 32 27 260 32 27 260 32 27 260 32 27 260 32 27 82 38 92 32 27
263 280 133 68 242 1 450 368 202 179 133 68 133 315 195 144 184 144 195 280 184 89 54 89 184 368
344 1 294 43 63 49 43 574 107 27 21 12 658 345 15 27 21 12 627 437 436 36 63 49 43 324 662 549 15 3 21 12 381 273 15 3 21 12 529 425 36 43 13 49 43 735 273 15 3 21 12 381 273 15 3 21 12 965 455 875 36 13 49
127 201 45 45 53 15 18 18 366 119 66 62 181 11 11 11 179 242 25 6 32 1 156 145 25 6 1 156 145 25 6 166 385 1602 324 317 29 9
5 11 76 1 344 33 28 18 184 161 141 51 20 34
61 73 163 8 567 62 44 132 132 376 30 94 108
170 320 136 51 5 28 144 92 51 5 28 184 74 636 16 5 28 260 107 3 21 80 260 80 165 20 7 242 246 80 20 7 242 227 1 145 33 16 7 342 133 51 7 33 242 51 33
40 142 204 116 68 192 9 68 354 217 179 142 179 215 155 144 68 107 90 86 583 160 133 51 133 195 133 204
425 13 43 667 21 59 1047 277 49 811 728 688 1140 235 52 128 47 713 953 13 49 1052 513 97 52 49 533 399 128 45 365 848 97 52 45 683 656 75 1184 513 296 212 49 533 69 257 1052 513 168 49 321 183 395 141 1213 131 95 369 550 290 172 550
60 91 319 545 1040 561 126 252 14 379 120 42 495 272 58 80 25 246 205 19 4 253 80 7 62 509 272 6 80 25 49 43 509 66 253 205 80 19 4 1026
61 32 24 66 6 181 40 34 246 6 10 41 642 6 10 1 132 6 10 61 32 24 66 6 181 40 34 246 6 10 41 634 10 38
1 84 57 124 1 139 124 26 1 84
78 20 34 453 177 389 62 76 122 161 189 76 122 161 141 76 122 161 360 100 28 76 122 161 263 28 62 45 89 141 62 45 89 72 62 45 89
19 96 25 773 19 3 205 25 96 96 25 3 19 1152 838 81 35 100 160 5 16 292 90 153 131 36 13 466 35 279 99 84 149 238 162 15 96 3 92 15 96 3 398 23 262 26 23 398 3 92 96 15 1337 92 96 238 162 15 3 43 260 15 3
9 5 5 11 11 10 3 12 26 210 3 12 26 2 136 10 12 26 2 210 3 12 26 41 776 76 148 44 129 1208 148 129 44 244 8 38 1 597