8 413 13 30 95 283 39 283 36 12 17 664 136 281 249 50 79 130 282 3 186 283 49 50 22
12 144 65 5 49 12 358 273 6 1046 144 15 195 172
126 42 64 38 276 621 668 126 42 64 651 79 64 49 38
25 19 1 61 4 19 2 117 4 19 2 68 20
42 121 652 204 101 42 228 652 204 101 42 121 330 350 101 42 121 438 350 101
113 15 6 8 127 97 52 39 123 127 225 30 127 123 113 14 30 94 169 113 225
41 611 91 88 894 2 607 95 60 1082 16 28 70 12 1 482 97 60 52 41
214 271 222 117 66 222 61 66 222 180 126 1087 158 25 286 1278 748 212 361 864 647
184 76 122 178 184 28 263 7 62 45 89 72
6 10 12 170 9 17 345 70 850 310 16 9 17
179 68 65 68 204 116 68 492 9 68 179 68 72 9 102 29 183 209
102 102 113 217 204 30 94 342 362 323 79 13 288 321 185 209
697 52 128 770 13 245 22 2 51 9 180
24 25 1 156 58 24 25 1 156 61 6 24 1 175 135 3 19 1 175 226 296
184 51 161 350 49 43 88 1 526 42 14
61 15 3 4 299 543 646 979 29 5 7 345 59 25 15 3 1
184 144 345 1 450 184 89 54 89 184 368 202 179 133 68 133 315 195 144 184 144 345
39 41 497 40 33 1 298 40 33 41 625 32 27 2 142 16 9 142 16 9 1 135 15
21 241 1393 296 219 219 455 66 19 4 246 19 24 4 241 455 66 19 4 538 20 7 24 24
497 16 9 1 554 100 40 590 153 79 689 32 27 41 1010 92 1 293 92 1 293 92
5 1183 33 54 739 33 572 5 1183 33 54 2 239 224 456 78 333 16 1288 20 54 161 65 161 239 224 456 78 333
37 1132 1705 7 62 45 86 37 1788 16 33
328 20 7 80 242 1 132 80 19 4 1 565 33 16
162 227 80 15 27 4 1893 1445 1053 777 957 752 70 90 5 100 28 53 15 16 100
512 88 144 89 5 144 183 43 144 51
291 14 30 120 866 52 128 118 1427 13 49 43 811 118 234 257 1095 43 108 43 623 97
590 65 62 134 28 584 168 128 360 584 590 413 641 126 1 294 39 305 195 1065 460 39 130 336 306
83 243 1 99 83 243 1 99 83 243 1 99 83 243 1 99 83 243 1 99
1 56 3 10 1 56 3 10 1 61 6 4 2 273 61
765 76 75 207 548 65 38 157 38 216 76 157 18 315 6 11 254 794 234 407 325 50 3 40 76 325
472 526 101 836 120 363 359 311 805 15 19 36 63 14 430 60 18 165 101 165 311 119 3 181 11 33 196 311 61 92
955 140 314 1 955 140 387 1 681 736 140 1 316 736 387
131 4 53 132 4 253 205 19 80 31 23 645
549 662 437 627 42 13 30 437 627 345 658 36 13 49 345
15 1 258 33 34 17 71 32 306 63 64 39 71 32 222
96 15 418 96 15 418 96 15 418 96 15 418 96 15 418 96 15 1 258 33 34 17 71
638 169 683 234 507 1001 118 319 1529 93 605 128 770 14 43 41 702 152 299 1199 319 522 1225 193 319 692 1349
32 1 156 150 32 1 605 168 103 187 96 15 418 96
3 96 25 19 3 147 35 330 35 175 19 3 205 25 96 3 25 19 96
1152 66 80 19 4 23 206 193 684 314 319 838 12 100 160 5 16 292 90 466 21 1519 262 23 132 80 4 19 12 21 260
857 1567 32 100 64 306 374 350 40 306 184 1616 505 79 64 374 295 350 22 77 126 872 229 71 246 654 253 1065
12 35 182 87 44 85 51 12 424 18 44 129 173 31 304 45 11 47 173 192 11 85 44 85 173 69
1 208 32 27 24 1 149 1 105 27 24 1 149 1 287
14 49 420 42 14 848 36 64 318 64
32 3 2 418 135 32 3 1 208 71 32 3 2 418 71 32 3 2 418 135 32 3 1 198 71 15 6 2 345 135 15 6
331 239 182 463 62 45 7 85 215 204 37 431 319 364 204 335 354 18 122 4 85 72
246 6 10 41 642 6 10 1 132 6 10 61 32 24 150 66 6 181 40 34 246 6 10 41 625 66 32 27 597 235
34 187 9 17 539 168 75 151 115 71 22 39 432 324 71 432 40 156 71 338 39 156 71 432 156 71
35 97 162 35 139 375 35 162 15 6 4 35 241 198 57 272 797 162 15 6
3067 2 136 26 1 73 23 31 70 31 1 53 211 69 182 31 1 878 2 127 70 85 188 137 137 521
39 79 1 476 39 43 22 1 326 194 79
14 30 637 103 118 766 39 43 308 1482 168 52
155 144 68 107 90 86 583 160 133 51
204 101 89 72 62 454 19 34 28 89 157 28 159 1 711 20 350 49
1 565 15 11 45 47 294 173 852 285 87 2
4 27 8 30 143 18 148 110 330 25 12 55 35 61 15 4 8 27 12 35 55
15 229 6 71 26 23 255 264 3 25 19 96 23 250 1144 229 162 15 71 6
114 63 1464 70 22 126 247 568 420 22 247 841 751 153 63 306 184 184 63 306 506 100 595 63 100 32 306 184 192
111 97 52 123 127 225 127 123 113 111 75 60 169 113 225
299 1 383 213 164 1086 261 1 491 411 411 308 1819 676 1301 125 1 429 299 708 3642 1138 702 510 2962 207
55 164 1539 23 81 1 73 81 37 1 147 10 37 1 119 10 81 1
41 609 29 40 5 41 773 25 32 3 1
40 5 5 40 17 187 78 1 105 10 71 6 3 32 3 10 66 1 198 25 48 25 4 13
45 85 138 70 8 1 565 15 11 45 47 294 173 852 285 87 2 409 88 108
578 531 30 22 550 28 1 303 20 28 1 287 6 21 2
639 14 101 851 14 101 1009 319 774 639 49 108 851 49 108 331 190 774 13 88 639 22 43 669 380
801 168 143 141 244 311 200 673 344 40 33 308 1839 5 17 29 40 5 17 164 775 77 9 7 77
103 143 128 1818 643 153 79 63 39 574 40 33 17 406 103 168 151 1 1322 414 13 103 118 207 780 282 87 657 235 151 91 248
617 101 14 88 821 63 36 342 882 49 13 43 909 14 36 63 911 14 101 88 909
427 599 494 414 1935 77 40 34 41 291
107 49 88 108 345 358 128 193 234 392 345 358 392 345 1 388 30
4 91 372 118 522 95 137 61 61 15 27 4 117 61 27 4
16 34 62 32 27 21 188 220 150 106 21 32 27 81 221 98 70 150 187 221 33 34 28
248 830 17 18 192 39 43 469 34 192 39 130 352
85 349 359 388 146 211 122 85 257 190 152 358 1199 415 842 595 396 643 366 167 196
16 443 162 96 6 58 10 15 3 96 5 418 71 22 126 13 186 5 17 78
139 124 26 1 139 124 26 1 84 57 124 1 137 38 26 1 137 38 26 1 137 38 26 1
1 86 24 21 132 19 27 10 1 132 19 27
49 318 13 30 26 84 26 281 373 13 30 259 84 294 63 14 146 433 294 63 14 146 521
330 46 281 45 111 173 93 8 35 26 259 53 479 18 44 276 26 113 85 87 44 77 173 12 23 46 31
17 107 3 10 392 3 10 54 17 18 56 10 743 118 207 17 18 138 10 12 461 10 12 102 18 44
225 123 739 330 83 1 359 1183 638 333 169 572 515 154 1 521 973 886 472 340
15 195 80 15 27 242 15 27 468 107 27 80 160 240 80 15 468
13 30 130 256 13 30 130 758 75 103 118 938 22 14 30
105 3 10 66 52 235 124 653 121 187 132 32 3 10 275 418 243 105 3 10 66 49 52 235 652 125 71 187 132 32
967 72 161 107 1 699 120 126 97 14 938 363 89 167 1 855 278 97 64 996 89 260 70 253 1 565 42
15 96 71 71 15 229 162 96 3 81
2 1080 347 266 2 65 141 185 113 232 340 532 467 246 6 10 2 363 22 39 1 526 22
61 1 547 95 75 60 118 830 7 18 107 2 290 36 13 49 1 393 36 13 49 2
190 638 408 1 1172 215 72 62 141 18 89 189 45 215 141 18 204 101 203 20 318 204 101 193 362 335
63 49 395 63 39 395 63 49 395 63 101 395 63 49 331 101 88 420
11 34 69 11 69 11 189 9 62 796 75 206 1209 9 62 339 64 94 628 5
139 26 124 1 84 57 124 1 84 57 124 1 139 124 26 1 84 57 124 1 139 26 124 1 147 55 124
1998 3 38 880 407 111 52 248 308 1757 15 10 730 234 223 95 103 308 1732
1 605 103 168 460 949 43 22 434 461 10 8 792 548 75 103 91 1280 548 22 39 30 2 876 893
162 15 115 6 71 115 71 15 6 1397 1160 29
54 7 62 2 72 122 171 2 102 47 171 2 69 85 171 404 57 35 84 23 31 12 46 10
533 72 863 513 168 7 183 283 469 51 68 1213 513 277 321 357 396 239 631 95 52 128 122 728 639 36 13 49 754 197 16 5
141 33 399 197 184 89 184 280 374 72 54 1476 90 51 54 51 144 51 54 51 512 116 68 65 180
185 209 192 14 43 271 628 65 17 18 448 102 102 65 217 134 5 288 87 393 65 7 11 343 331 179 102 271 173 196 11 182